{
  "name": "第五关 - 登峰造极",
  "map": [
    "###############",
    "#.............#",
    "#.X.X.X.X.X...#",
    "#.............#",
    "#...$.$.$.$...#",
    "#.............#",
    "#...$.$.$.....#",
    "#.X.X.X.X.....#",
    "#.............#",
    "#...$.........#",
    "#.X...........#",
    "#.@...........#",
    "###############"
  ]
}
