{
  "name": "第四关 - 炉火纯青",
  "map": [
    "#############",
    "#...........#",
    "#.X.X.X.X...#",
    "#...........#",
    "#...$.$.$...#",
    "#...........#",
    "#...$.$.....#",
    "#.X.X.X.....#",
    "#...........#",
    "#.@.........#",
    "#############"
  ]
}
