{
  "name": "第二关 - 初窥门径",
  "map": [
    "##########",
    "#........#",
    "#.X..X...#",
    "#...$....#",
    "#.X.$.X..#",
    "#...$....#",
    "#....X...#",
    "#.@......#",
    "##########"
  ]
}
