{
  "name": "第一关 - 新手入门",
  "map": [
    "  #####  ",
    "  #...#  ",
    "###.$.###",
    "#..X$X..#",
    "#.X.$.X.#",
    "#...@..X#",
    "#.......#",
    "#########"
  ]
}
