{
  "name": "第三关 - 渐入佳境",
  "map": [
    "  ########  ",
    "  #......#  ",
    "###.X.X..###",
    "#....$.....#",
    "#.X.$.$.X..#",
    "#....$.....#",
    "#..X.X.X...#",
    "#.@........#",
    "############"
  ]
}
